건보공단: 국민건강보험공단
게임위, 게관위[1]: 게임물관리위원회
경실련: 경제정의실천시민연합
노동부: 고용노동부
공본: 공군본부
공수처: 고위공직자범죄수사처
공정위: 공정거래위원회
과기부: 과학기술정보통신부
과기원: 과학기술원
국과수: 국립과학수사연구원
국과연: 국방과학연구소
국수본: 국가수사본부
국정원: 국가정보원
국토부: 국토교통부
국편위: 국사편찬위원회
권익위: 국민권익위원회
금감원: 금융감독원
금융위: 금융위원회
건준: 조선건국준비위원회
기무사: 국군기무사령부 (現 국군방첩사령부)
기재부: 기획재정부
농협: 농업협동조합
대진연: 한국대학생진보연합
도공: 한국도로공사
도철: 도시철도, 서울도시철도공사[2]
문체부: 문화체육관광부
민노총: 전국민주노동조합총연맹
민단: 재일본대한민국민단
민변: 민주사회를 위한 변호사모임
반민특위: 반민족행위특별조사위원회
방심위: 방송통신심의위원회
방통위: 방송통신위원회
방첩사: 국군방첩사령부
범투본: 문재인하야범국민투쟁본부
보안사: 국군보안사령부 (現 국군방첩사령부)
보훈부: 국가보훈부
부교공: 부산교통공사
비대위: 비상대책위원회
빙연: 대한빙상경기연맹
생기원: 한국생산기술연구원
서교공: 서울교통공사
서메: 서울메트로
선관위: 선거관리위원회
수기사: 수도기계화보병사단[3]
수방사: 수도방위사령부
수협: 수산업협동조합
식약처[4]: 식품의약품안전처
신천지: 신천지예수교 증거장막성전
심평원: 건강보험심사평가원
안기부: 국가안전기획부
안보리: 유엔 안전보장이사회
안보실: 국가안보실
에경연: 에너지경제연구원
여가부: 여성가족부
영등위: 영상물등급위원회
영진위: 영화진흥위원회
육본: 육군본부
육사: 육군사관학교
의협: 대한의사협회
인권위: 국가인권위원회
인수위: 대통령직인수위원회
임정: 임시정부
전경련: 전국경제인연합회
전교조: 전국교직원노동조합
전장연: 전국장애인차별철폐연대
정의연: 정의기억연대
정출연: 정부출연연구기관
조총련: 재일본조선인총연합회
주금공: 한국주택금융공사
중기부: 중소벤처기업부
중대본: 재난안전관리본부 산하 '중앙재난안전대책본부'
중정: 중앙정보부
지자체: 지방자치단체
질청: 질병관리청
축협: 축산업협동조합중앙회, 대한축구협회
한노총: 한국노동조합총연맹
한수원: 한국수력원자력
한은: 한국은행
한전: 한국전력공사
한총련: 한국대학총학생회연합
합참: 합동참모본부
항우연: 한국항공우주연구원
해본: 해군본부
해수부: 해양수산부
행안부: 행정안전부
국당: 국민의당(2016년), 국민의당(2020년)
국민회의: 새정치국민회의
국힘, 국힘당: 국민의힘
개혁당: 개혁신당
민자당: 민주자유당
민정당: 민주정의당
민주당: 더불어민주당 및 대한민국의 민주당계 정당
민진당: 대만 민주진보당
새민련: 새정치민주연합
우리당: 열린우리당
자민당: 일본 자유민주당
자민련: 자유민주연합
조국당: 조국혁신당
통진당: 통합진보당
통합당: 미래통합당
한국당: 자유한국당
교특법: 교통사고처리 특례법
국보법: 국가보안법
금산법: 금융산업구조조정을위한법률
단통법: 이동통신단말장치 유통구조 개선에 관한 법률[14]
대광법: 대도시권 광역교통 관리에 관한 특별법
민소법: 민사소송법
민집법: 민사집행법
부수법: 부정수표 단속법
부실법: 부동산 실권리자명의 등기에 관한 법률
성폭법: 성폭력범죄의 처벌 등에 관한 특례법
아청법: 아동·청소년의 성보호에 관한 법률
자배법: 자동차손해배상 보장법
중처법: 중대재해 처벌 등에 관한 법률
정통망법: 정보통신망 이용촉진 및 정보보호 등에 관한 법률
집시법: 집회 및 시위에 관한 법률
폭처법: 폭력행위 등 처벌에 관한 법률
테방법: 국민보호와 공공안전을 위한 테러방지법
특가법: 특정범죄 가중처벌 등에 관한 법률
특검법: 특별검사의 임명 등에 관한 법률
특경가법, 특경법: 특정경제범죄 가중처벌 등에 관한 법률
행소법: 행정소송법
형소법: 형사소송법
민소법: 민사소송법
원자행: 원인에 있어서 자유로운 행위
위수증: 위법수집증거배제의 원칙
위전착: 위법성 조각사유의 전제사실에 대한 착오
금투세: 금융투자소득세
병특: 병역 특례
공보의: 공중보건의사
공익: 공익근무요원 (現 사회복무요원)
상근: 상근예비역
전문연: 전문연구요원
생기부: 학교생활기록부
수능: 대학수학능력시험
양도세: 양도소득세
종부세: 종합부동산세
종소세: 종합소득세
주담대: 주택담보대출
학고: 학사경고
학력고사: 대학입학 학력고사
학종: 학생부종합전형
인작: 인기 작품
스선: 스태프 선정
문답: 묻고 답하기
노팁: 노하우&팁
엔이: 엔트리 이야기
제건: 제안 및 건의
ㅈㄱㄴ: 제목이 내용이라는 뜻
ㅎㅅㅎ: 말을 끝낼 때 하는 말
글삭: 글을 삭제하라고 할 때 쓰는 말
띵작: 걸작
믱장: 걸작
ㄳㅍ: 글 삭제 필수
ㄳㅊ: 글 삭제 추천
ㄷㅅㅊ: 댓글 삭제 추천
ㄷㅅㅍ: 댓글 삭제 필요
ㅈㄱㄳ: 좋아요 관심작품 감사
ㅈㄱㄴ: 제목이 곧 내용
ㅅㄱㄴ: 사진이 곧 내용
ㄴㄱㅈ: 내용이 곧 제목
ㅁㄷㅅ: 문제 될시 삭제
ㅁㄷㄱ: 모르면 답변 금지
ㅇㄱㄹㄷ: 어그로 댓글
게미: 게시판 미스
제건: 제안 및 건의
노팁: 노하우&팁
아인세: 아름다운 인터넷 세상
묻답: 묻고 답하기
합작: 합동 작품
영자: 운영자
인작: 인기작품
스선: 스태프 선정
미아모: 미래의 아티스트 모여라
사본: 작품을 따라서 만드는 것
리메이크: 작품을 조금 변형해서 만드는 것
ㄷㅈㅅㄱ: 등장을 한 것.
ㄳㅊ: 글 삭제 추천
ㅈㄱㄳ: 좋아요 관심작품 감사
ㅈㄱㄴ: 제목이 곧 내용
ㄷㅈㅅㄱ: 등장을 했다는 것
ㅌㅈㅅㄱ: 퇴장을 했다는 것
ㅅㅁㅅㄱ: 일이 있어서 엔트리를 하고 있다가 잠시 나갈때 쓰는 말.
썸넬: 썸네일
ㅅㄱ: 신고 또는 수고
디코: 디스코드(커뮤니티 사이트)
매크로: 공유하기 첫번째 칸에 올려져 있어서 좋관이 많이 늘음.
레어닉: 콘솔에다가 코드를 붙이면 아이디를 (--) 이런 글자도 사용 가능합니다.
ㄴㄴ: 아니라는 뜻
ㅇㅇ: 맞다는 뜻
ㅇㅅㅇ: 표정
ㅇㅁㅇ: 표정
작: 작품
부계인작: 부계로 좋아요를 눌르는 것
프사: 프로필 사진
배사: 배경사진
영정: 영구 정지
좋관: 좋아요와 관작
A.D.: Anno Domini (서력기원)
A.I.: Artificial Intelligence (인공지능), Avian Influenza (조류 인플루엔자)
A.M.: Ante Meridiem (오전)
AMC: American Mathematics Competitions (미국 수학 경시대회)
AIME: American Invitational Mathematics Examination
ATC: Air Traffic Control (항공관제)
B.C.E.: Before Common Era (기원전)
ATIS: Automatic Terminal Information Service (공항정보방송업무)
C.E.: Common Era (서력기원)
COVID-19: Coronavirus disease 2019 (코로나바이러스감염증-19)
IAEA: International Atomic Energy Agency (국제 원자력 기구)
ICU: Intensive Care Unit(중환자실, 집중치료실), Information and Communications University(한국정보통신대학교)
IMF: International Monetary Fund (국제통화기금)
IMO: International Maritime Organization (국제해사기구), International Mathematical Olympiad (세계 수학 경시대회)
IPA: International Phonetic Alphabet (국제음성기호)
IPhO: International Physics Olympiad (세계 물리 경시대회)
ISBT: InterState Bus Terminal (주간버스터미널)
KMO: Korean Mathematical Olympiad (한국 수학 경시대회)
LASER: Light Amplification by the Stimulated Emission of Radiation (레이저)
LSA: Lubricant Small Arms (소형화기용 윤활유)
P.M.: Post Meridiem (오후)
ROTC: Reserve Officers Training Corps(예비 장교 교육단)
UN: United Nations(국제연합)
Univ.: University
WHO: World Health Organization(세계보건기구)
WTO: World Trade Organization(세계무역기구), Warsaw Treaty Organization(바르샤바 조약기구)
WTF: What The Fuck
WWF: World Wide Fund for nature (세계야생동물기금)
WWF: World Wrestling Federation (세계 레슬링 연맹)
AMD: Advanced Micro Devices
